6,6
1,1,1,1,1,1
1,0,0,0,0,1
1,4,2,4,3,1
1,0,0,0,0,1
1,0,0,0,0,1
1,1,1,1,1,1